##########
#I..#....#
#.#>.^#..#
#...#.##.#
#..#.....#
#...##.#.#
#.#.....O#
##########
