##########
#...#....#
#.#>.^#..#
#...#.##.#
#..#.....#
#...##.#.#
#........#
##########
